10
2
60
30
111111111111111111111111111111111111111111111111111111111111
100000000000000000000000000000000000000000000000000000000001
100000000000000000000000000000000000000000000000000000000001
100000000000000000000000000000000000000000000000000000000001
100000000000000000000000000000000000000000000000000000000001
100000000000000000000000000010000000000000000000000000000001
100000000000000000000000000010000000000000000000000000000001
100000000000000000000000000010000000000000000000000000000001
100000000000000000000000000010000000000000000000000000000001
100000001111111000000000000010000000001111111111100000000001
100000000000000000000000000010000000000000000000000000000001
100000000000000000000000000010000000000000000000000000000001
100000000000000000000000000010000000000000000000000000000001
100000000000000000000000000010000000000000000000000000000001
100000000000000000000000000010000000000000000000000000000001
100000000000000000000000000000000000000000000000000000000001
100000000000000000000000000000000000000000000000000000000001
100000000000000000000000000000000000000000000000000000000001
100000000000000000000000000000000000000000000000000000000001
100000000000000000000000000000000000000000000000000000000001
100000000111111111111111111111111111111111111110000000000001
100000000111111111111111111111111111111111111110000000000001
100000000111111111111111111111111111111111111110000000000001
100000000000000000000000000000000000000000000000000000000001
100000000000000000000000000000000000000000000000000000000001
100000000000000000000000000000000000000000000000000000000001
100000000000000000000000000000000000000000000000000000000001
100000000000000000000000000000000000000000000000000000000001
100000000000000000000000000000000000000000000000000000000001
111111111111111111111111111111111111111111111111111111111111